Anansi Awapa Watu Hadithi -- Anansi Gives People Stories
Basi Kubwa La Bluu -- Big Blue Bus
Rangi za Upinde -- Colors of a Rainbow
Animals of Afrika
What Animals Eat 
Nguruwe Hawaruhusiwi -- No Pigs Allowed
Ninapenda Kusoma--I Like to Read
Simba Na Ngiri--Lion and Warthog
Teksi Ya Nanu--Nanu's Taxi
Upepo--Wind
Magozwe
Unafanya Nini? -- What are you doing?
Middle Row
Why does the lion roar? (Coloring)
Mbweha Na Sungura -- Jackal and Rabbit
Mpira Wangu Mwekundu -- My Red Ball
Mtende -- Palm Tree
Ni Kazi Gani Iliyo -- Which Work is The Most Important
Bottom Row
Kusafisha(CCI) -- Cleaning Up
Siku ya Mvua -- Rainy Day
Mbali Sana (CCI) -- Far Away
Adun Mrembo -- Adun The Beautiful
Chura Na Nyoka -- Frog and Snake
Jinsi Usiku -- How Night Came to Opio's Village
Kimbia Sungura, Kimbia! -- Run Rabbit Run!
Kubwa Na Ndogo -- Little and Big
Maharagwe Yanayomea -- The Sprouting Bean
Marafiki -- Friends
Mbio Kuhimiza Umoja Wa Afrika -- Africa Unity Race
Ng'Ombr Wetu Pendo -- Pendo Our Cow
